11111111111
1P1X10C1C11
10000011001
11100001011
10001000011
10111X11011
10XC10E1X11
10001011111
11111111111
