111111111111111111111111111
111X0000000000C00000000X111
111011111111111111111110111
11101111X0C111111C000X10111
111011100001111100000000111
111011C000011111CX111000111
11101X001001111111110000111
1P0000011000C00C000X00000E1
111000X00000011111000110111
1110C000000001111X001110111
111011111X011111C0011110111
1110111110011111000X0000111
111011111XC1111100000000111
111011111111111111111110111
111C000000000C000000000X111
111111111111111111111111111
