111111
110XE1
1P0011
1100C1
1C0X11
111111
