1111111111111111
1P01C11C11C1C1E1
100101C0C0010001
1001011111011101
10000C00000C0001
1111111111111111
