111111111111111111111111111
111C0000000000000000000C111
111011111111111111111110111
11101111CCC111111CCCCC10111
1110111CCCC11111CCCCCCC0111
111011CCCCC11111CC111CC0111
11101CCC1CC111111111CCC0111
1P00CCC11CC0000000CCC0000E1
1110CCCCCCCCC11111CCC110111
1110CCCCCCCCC1111CCC1110111
111011111CC11111CCC11110111
111011111CC11111CCCCCCC0111
111011111CC11111CCCCCCC0111
111011111111111111111110111
111C0000000000000000000C111
111111111111111111111111111
