1111111111111
1P000000000E1
1CCCCCCCCCCC1
1P00000000001
1111111111111
