1111111111111
1P00000000001
1CCCCCCCCCCC1
1000000000001
1111111111111
