1111111111111
1P00000000011
1CCCCCCCCCCC1
10000000000E1
1111111111111
1
