1111111111111
1P00000000011
1CCCCCCCCCCC1
1000000000 E1
1111111111111
