111111111111111
1P0000000000001
100000000000001
1000000C0000011
1000000000001E1
111111111111111
