111111111111111
1P0100000000001
10100C000000001
1C010000C000001
1010000000E0001
111111111111111
