111111111111111
1P0000010000001
100000010000001
100C0001000C001
100000EC0000001
111111111111111
