111111111111111
1P0000010000001
100000010000001
1C0000010000001
1000000100C00E1
111111111111111
