111111111111111
1P000000C000001
100000001000101
111111111111011
1000000000C00E1
111111111111111
