111111111111111
1P0000010000001
100000010000001
100000010000001
1000000EC000001
111111111111111
