111111111111111
1P0000000000001
100000000000001
111111111111111
1000000000C00E1
111111111111111
