1111111
1P00001
100C001
1c000E1
1111111
