1111111
1P00001
100C001
100O0e1
1111111
