1111111
1P01101
100C0E1
1C01C11
1111111
