111111111
1P0000111
100C00111
10000E-11
111111111
