1111111
1p00001
100C001
10000E1
1111111
